33333333333333333333333333333333333333333333333333333333333333333333333333333333333333333333333333333
3...................................................................................................3
3....3...........3333.................2.............................................................3
3...3................................22.............................................................3
3...................................2222............................................................3
3..3...............313...............22.............................................................3
3...................................................................................................3
3...3...........33..................................................................................3
3....3..............................................................................................3
3...................................................................................................3
3...................................................................................................3
3...................................................................................................3
3...................................................................................................3
3...................................................................................................3
3...................................................................................................3
3........................................................................11111111111................3
3..........................................................................111111...................3
3......................................................1............................................3
3..........1111........................................1............................................3
3...................................................................................................3
3...................................................................................................3
3...................................................................................................3
3...................................................................................................3
3...................................................................................................3
3.......................................................................1111111.....................3
3...................................................................................................3
3...................................................................................................3
3...................................................................................................3
3...................................................................................................3
3...................................................................................................3
3...................................................................................................3
3..........1111.....................................................................................3
3...................................................................................................3
3...................................................................................................3
3...................................................................................................3
3...................................................................................................3
3...................................................................................................3
3...................................................................................................3
3...................................................................................................3
3..........1111.....................................................................................3
3...................................................................................................3
3...................................................................................................3
3...................................................................................................3
3...................................................................................................3
3...................................................................................................3
3...................................................................................................3
3...................................................................................................3
3...................................................................................................3
3...................................................................................................3
3..........1111.....................................................................................3
3...................................................................................................3
3...................................................................................................3
3...................................................................................................3
3...................................................................................................3
3...................................................................................................3
3...................................................................................................3
3...................................................................................................3
3......................................................................1111111......................3
3.....................................................................1111111111....................3
3..........1111.........................................................1111111.....................3
3...................................................................................................3
33333333333333333333333333333333333333333333333333333333333333333333333333333333333333333333333333333.